111111111111111
1111001P01E1111
111110110100001
1000000C0000001
111111111111111
